1	f	f	f	f	f	f
2	d	s	s	s	s	s	
3	s	s	s	d	s	d	
4	d	d	d	d	d	d	
5	s	s	s	s	s	s	
6	d	d	s	d	s	d	
7	s	s	d	s	d	s
8	s	d	d	s	d	d	
9	f	f	f	f	f	f	
10	s	s	s	d	s	s	
11	d	d	d	d	d	d	
12	s	d	d	s	d	s	
13	d	s	s	s	s	s	
14	d	d	d	d	d	d	
15	s	s	s	s	s	d	
16	d	d	d	d	d	s	
17	f	f	f	f	f	f	
18	s	s	s	s	s	d	
19	d	d	d	d	d	d	
20	s	d	s	s	s	s	
21	d	s	d	s	d	s	
22	s	d	d	d	d	d	
23	d	s	s	s	s	d	
24	s	d	d	d	d	s	
25	f	f	f	f	f	f	
26	d	d	d	d	s	d	
27	d	s	s	s	s	s	
28	s	d	d	d	d	d	
29	s	s	s	s	s	s	
30	d	s	s	s	s	s	
31	s	d	d	d	d	d	
32	d	s	s	d	d	s	
